111111111111111111111111111111111111
10000000000100000E000000100000000001
1000000000C100000000C00010000000C001
10000000000100000000000010000C000001
100000000001000000001111100000011111
100000000000000000000000100000000001
10000000000000000W000000100000000001
100P00000000000000000000000000000001
1000000000C000000000000000000000C001
10000000001000000000C000100000000001
111111111111111111111111111111111111